Crossword clues for 'MORAL'

Clue	Answer
Lesson at the end (5)	MORAL
Fable's lesson (5)	MORAL
Aesop's point (5)	MORAL
Significance of a story (5)	MORAL
Behaving ethically (5)	MORAL
Aesopian ending (5)	MORAL
Fable offering (5)	MORAL
Fable finish (5)	MORAL
Lesson taught by a fable (5)	MORAL
Aesop's ending (5)	MORAL
___ support (5)	MORAL
Fable finale (5)	MORAL
A lesson in words (5)	MORAL
Fable point (5)	MORAL
Story's significance (5)	MORAL
Story conclusion, sometimes (5)	MORAL
What we all should be (5)	MORAL


Crossword clues for 'RIGHT'

Clue	Answer
Legal entitlement (5)	RIGHT
A common turn (5)	RIGHT
Type of turn (5)	RIGHT
One way to turn (5)	RIGHT
"Of course!" (5)	RIGHT
Conservative; correct (5)	RIGHT
Constitutional guarantee (5)	RIGHT
Correct; proper (5)	RIGHT
"Correct-a-mundo" (5)	RIGHT


Crossword clues for 'FUGUE'

Clue	Answer
Composition involving a repeated interwoven melody (5)	FUGUE
Type of composition that Bach is noted for (5)	FUGUE
Polyphonic composition (5)	FUGUE
Bach composition (5)	FUGUE
Contrapuntal music (5)	FUGUE


Crossword clues for 'MAFIA'

Clue	Answer
Criminal organisation (5)	MAFIA
Underworld "family" (5)	MAFIA
Group at some crime scenes (5)	MAFIA
Crime syndicate (5)	MAFIA
Group exerting a hidden sinister influence (5)	MAFIA
Puzo subject (5)	MAFIA
Group with rackets (5)	MAFIA
Crime-fighter's target (5)	MAFIA
Criminal organization (5)	MAFIA
Corleone's group (5)	MAFIA
Criminal society (5)	MAFIA
"The Sopranos" subject (5)	MAFIA
Group that offers "protection" (5)	MAFIA


Crossword clues for 'ANTRE'

Clue	Answer
Cavern, in poetry (5)	ANTRE
Cavern or cave, in poetry (5)	ANTRE


Crossword clues for 'LIEGE'

Clue	Answer
Belgian city (5)	LIEGE
Medieval subject (5)	LIEGE
Lord's feudal title (5)	LIEGE
Loyal vassal (5)	LIEGE
Sovereign lord (5)	LIEGE
Feudal vassal or lord (5)	LIEGE
Feudal master (5)	LIEGE
Title in "Monty Python and the Holy Grail" (5)	LIEGE
Loyal subject or city in Belgium (5)	LIEGE
Loyal subject (5)	LIEGE
Title fit for a lord (5)	LIEGE
Subject's superior (5)	LIEGE
Royal supporter (5)	LIEGE
Feudal lord (5)	LIEGE
Feudal subject (5)	LIEGE
Belgium city on the Meuse (5)	LIEGE
City in Belgium (5)	LIEGE
Feudal superior (5)	LIEGE
Lord of the Middle Ages (5)	LIEGE
Loyal subject, or city in Belgium (5)	LIEGE
